BBA	SOM
BDC	SOD
MAT	MAT
CHE	CHE
FRL	French
LAW	SOL
BBB	SOM
BBE	SOM
BDF	SOD
MBA	SOM
BBL	SOL
CSA	SOIS
CSE	SOCSE
BSE	SOM
BSM	SOD
PHY	PHY
COM	SOC
EEE	EEE
ECE	ECE
SOC	SOC
BCH	SOC
MEC	MEC
BCL	SOL
BAJ	SOMS
BAL	SOL
CIV	CIV
DES	SOD
MAH	SOC
BAV	SOM
KAN	Kannada
MGT	SOM
PET	PET
ENG	English